%%%%%
% . %
%.G.%
% . %
%. .%
%   %
% O.%
%   %
%P .%
%%%%%
