%%%%%
% . %
%.G.%
% . %
%. .%
%   %
%  .%
%  O%
%P .%
%%%%%
